


          *****************************************************************************************************************************************************
          *^^^^^^^^^^^^^^^^^^^^^^^^^^^^^^^^^^^^^^^^^^^^^^^^^^^^^^^^^^^^^^^^^^^^^^^^^^^^^^^^^^^^^^^^^^^^^^^^^^^^^^^^^^^^^^^^^^^^^^^^^^^^^^^^^^^^^^^^^^^^^^^^^^^*
          *^^^^^^^^^^//////^//////^^^^^^^^^^^^^^^^^^^^^^^^^^^^^^^^^^^^^^^^^^^^^^^^^^^^^^^^^^^^^^^^^^^^^^^^^^^^^^//////^ ^^^^^^^^^^^^^^^^^^////^^^^^     ^/^^^^*
          *^^ ^^^^   ^    ///    //////^^^^^/^^^^^^\^^^^^^^\\\\\^^//////^^^^^^^^^         ^^^^^^^^^^^^^^^^^^^ ^^^    //^ ^^///////^^^^/////^^//////      /^^^^*
          *^^^^\^^                    /^^ ^^/^^^^^^\ ^^^\\\\^         ^///^ ^^^               ^^^^^^^                 //^^^      //////^                ^//^^^*
          *^^^\\                      /^^^ ^///^^\\\^^\\\                ///^^^^^              ^^^^^^^                 ///^                        ^^^    /^^^*
          *^^\\         ^^^^          ///^^^^^//\\^^^\\                  ^^///^^^^^^^^^^^^^    ^^ ^^^^^^^^^^            ^/^^       /^^^^^^^^^     /^^^^   //^^*
          *^^\     ^^^^^^^^^           ^////^^^^^^^^\\       ^^^^^^^^^^      ^/////////^^^^^    ^ ^^^^  ^^^^            ^///^^    //^^^/^^^^^^    / ^^^^   /^^*
          *^^\    ^^^^^^^^\^              ^/////^^\\\       ^^^^^^^^^^^^             ^///^^^    ^^^^^^^ ^^^^^^^^^          ^/^    / ^^^/^^^^^^    ^/////  //^^*
          *^^\   ^^^^^\\\\\                   ^^^          ^^^^// ^^^^^^^^              //^^     ^^\  ^^^ ^^^^^^^^^^              ///^^///^^^^           //^^^*
          *^^\   ^^^^\\                                  ^/^^^^^//^ ^^^^^^^^^^^\\                ^\\    ^^^^^^^^^^^^^^^^            ///^^^^^^^          //^^^^*
          *^^\  ^^^^\\         ^^^^^^                    ^// ^^^^/^^^^^^^^^^^^^^\                ^\\      ^^^^^^^^ ^^^^^^            ^////^^^          //^^ ^^*
          *^^\  ^^^^\          ^/^^^^^^^^^^^               ///^^^/ ^^^^^^^ ^^^^^\         //^^\  ^\\             ^^/^^^^^               ^^^           ^/ ^^^^^*
          *^^\  ^^^^\           //^^^^^^^^^^^^^             ^/^^^^/////^^^^^^^^^\         ^/^^\   ^\              ^/^^^^^                             ^/^^ ^^^*
          *^^\  ^^^^\\           ////^^^^^^^^^^^^            /^^^^^^^^^^^^^^^^^^\         ^/ ^\   ^\\        ^    ^/^^^^^^^                           ^^^^^^^^*
          *^^\   ^^^^\\\\\\^^    ^^^////^^^^^/^^^^^^^^^^^    //^^^^^^^^^^    ^^^\          /^^\\   ^\\   ^^^^^^   ^///^^^^^^                          ^^^ ^^^ *
          *^^\\    ^^^^^^^^\\^         ///^^^//^^^^^^^^       ////^^^^^      ^^^\\         /^^^\    ^^^^^^^^^^^      //^^^^^^                        ^^^^^^^^^*
          *^ ^^\\\^^^ ^^^^^\\^\         ^///^^//////^^^^^                  ^^^^^^\         /^^\\^                    ^//^^^^^^^                      ^^^^ ^^ ^*
          *^^^^^^//////^\\\\^^\            ///^^^^^//^^^^^                ^^^^^\\\         /^\    /^         ^^^      ^/^^^^^^^^^^       /^^^^      ^^^^^^^^^^*
          *///////   ^// ^^\\\\              ///^^^^/////^^^^           ^^^^^\\\           ^^^   //^^^^^^^\\^^^^^^    ^/^^// ^^^^^^^    //^^^^^^^^^^^^^^^ ^^ ^*
          *            ///\\                  ^///^^^^^^^^^^^^^^^^^^^^^^^^^\\^                  //^^^^//^^^\\^^^^^     / ^^/^^^^^^^\    /^^^^^^^^^^^^^^^^^^^^^*
          *                                      ////////^ ^^^^^^^^^\^^^^^\\                    //^^^^/^^^^\\^^^^^     / ^^^/^ ^^^^\    ///^^^^^^^^^^^^^^^^^^ *
          **^^^^^^^                                      ////^^^^^^\^^^\\\\^                    ^//^^^////^\^^^  ^   ^//^^^^/^^^^^\\     ^//^^^^^^^^^^^^^^^^^ *
          *^^^^^^^^^^                                      ^^//^^^^\ ^\                           /////////////     ^// ^^^//^^^^^\        ///^^^^^^^^^^^///^ *
          *^^^ ^^^^^^^^ ^^^^^\                  ^^            //^^^\^^\        \                        ^^  ^^/      /^ ^^^/ ^^^^\\          ////^^^^^^///    *
          *^^^ ^^ ^^^^^^^^^^^\               ^^^^^^^^^^^       ///^\\^\        \\                                    /^^^^//^^^\\\             ^////////      *
          *^ ^^^^^^^^^^^^^^^\^            ^^^^^//^^^^^^^^^      ^/^^\^\\       ^\            ^^^^^                  //^^ ^/^^^^\                              *
          *^^^^^^^^^^////\\\\     ^^^^^^^^^^^^^/^^^^\\^^^^       /^^^^^\\     ^^^\\       /^^^^^^^^                ^/^^^ ^//^^^\                              *
          *^^^^^^^^\\\\\\\^       ^^^^^^^^^^^^^///^^^\^^^^       /^^^^^^\\\\  ^^^^\       ^/////^^^                ^/^^^^^^//^^\                 ^^^^^        *
          *^^^^^^^^\          ^^^^^^^^^^^^^^^^^^^^/\\ ^^^    ^^^^^^^^^^^^^^^^^^^^^\^           /^^^                ^/^^^^^^^^^^\           ^^^^^^^^^^^^^^ \   *
          *^^^^^^^\\         ^^^^^^^^ ^^^^//////^^^/^^^^   ^^^^^^//////^^^^^////^^\^           /^^^^^^             ^//////^^^^\\          ^^^^^^^^^^^ ^^^^\\  *
          *^^^^^^\\        ^^^^^^^  ^^^\\      /^^^^^^^    ^^^^\\\    ///////^//^^\^           /^^^^^^^^           ^/   ^//^^\\           ^^^^^^^^^^^^^^^^^\\ *
          *^^^^^^\       ^^^ ^^^^^ ^^^\\       /^^^^^     ^^^^\\              /^^^\^           ///^^^^^^^                 //^\^           ^^^^^^^^^ ^^ ^^^^^\ *
          *^^^^^^\       ^^ ^^ ^^^^^^\\      ///^^^^^    ^^^^^\        ^^^^^^^^^^\\              //^^^^\^^                 ^^^       ^    ^//^^^^//////^^^ ^\ *
          *^^^^^\\       ^^^^^^^\\\\\\       /^^^^^^^    ^^^^^\        ^^^^^^^^\\\                /^^^^\^^^         ^^^^^\           /^     //////^   //^^^^^^*
          *^^^^\\     ^^^^^^^^^\\            /^^^^^^^    ^^^^^\        ^^^\\\\\\                 //^^^^\\\^^^     ^^^^^^^\           /^^               /^^^^^^*
          *^^^^\      ^//^^^^^^\\            /^^^^^^^    ^^^^^\          ^\                     //^^^^^^^\^^^^^^^^^^^^^^^\           //^^^             //^^ ^^*
          *^^^\\      ^///// ^^^\^^^         /^^^^^^     /^^^^\\                               ^^^^^^ ^^\\ ^^^^\\^^^\\\\\^            ///^^^^^^^^^^     / ^ ^^*
          *^^^\            //^^^^^^^^^       ^^^^^^^     ///^^^\\                              ^^^^^^^^^^^^^^^^\^^^\                    /////^^^^^^^^   ////^^*
          *^^^\             ////^^^^^^                     //^^^^^^                            ^^//^^^//////^^^\^^ \                       ^/// ^^^^^    ^^///*
          *^^^\                 /^^^^^              ^^^^   ^//^^^^^^^^        ^^                 ^/////    / ^^\^^ \               ^^^^^      /^^^^^^       //*
          *^^^\                 /^^^^^             /^^^^^    ////^^^^^^^^^    ^^^^^^                       /^^^\^^^\\              ^^^^^^     ^^^^          /^*
          *^^^\\\      ^^^^^    ^^^^^^^            ///^ ^^^     ///////^^^^^^^^^ ^^^^^^^^^^^^^^^^^^^^^^^^^^^^^ ^^^^^\\\\            ^^^^^    ^^^^           /^*
          *^^^^^\^^^^^^^^^^^^   ^^^^^^^^             //^^^^^^         ///^^^^^^^^^^^^^^/^^^^^/^^^^^^^^^^^\^^^^^^^^^^^^^\          ^^^^ ^^    ^^^^^^^^       ^^*
          *^^^^^^^^^^^^^^^^^^^^^^^^^^^^^^^^^^^^^^^^^^^^^^^^^^^^         ^^^^^^^^^^^^^^^^//^^^/^^^^^^^^^^^^\^^^^^^^^^^^^^^^^^^^^^^^^^^ ^^^^^^^^^^^^^^^^^    ^^^*
          *****************************************************************************************************************************************************